                                                                                                    
                               ║                                 ║                                  
                               ║                                 ║                                  
                               ║                                 ║                                  
                               ║                                 ║                                  
                               ║                                 ║                                  
                               ║                                 ║                                  
                               ║                                 ║                                  
                               ║                                 ║                                  
                               ║                                 ║                                  
                               ║                                 ║                                  
                               ║                                 ║                                  
                               ╚═════════════════════════════════╝                                  
                                                                                                    
                                                                                                    
                                                                                                    
                                                                                                    
                                                                                                    
                                                                                                    
                                                                                                    
                                                                                                    
                                                                                                    
                                                                                                    
═══════════════════════════════╗                                 ╔══════════════════════════════════
                               ║                                 ║                                  
                               ║                                 ║                                  
                               ║                                 ║                                  
                               ║                                 ║                                  
                               ║                                 ║                                  
                               ║                                 ║                                  
                               ║                                 ║                                  
                               ║                                 ║                                  
                               ║                                 ║                                  
                               ║                                 ║                                 