                                                                                                    
                               ║                                 ║                                  
                               ║                                 ║                                  
                               ║                                 ║                                  
                               ║                                 ║                                  
                               ║                                 ║                                  
                               ║                                 ║                                  
                               ║                                 ║                                  
                               ║                                 ║                                  
                               ║                                 ║                                  
                               ║                                 ║                                  
                               ║                                 ║                                  
═══════════════════════════════╣                                 ╚══════════════════════════════════
                               ║                                                                    
                               ║                                                                    
                               ║                                                                    
                               ║                                                                    
                               ║                                                                    
                               ║                                                                    
                               ║                                                                    
                               ║                                                                    
                               ║                                                                    
                               ║                                                                    
                               ║                                                                    
                               ╠═════════════════════════════════╦═════════════════════════════════ 
                               ║                                 ║                                  
                               ║                                 ║                                  
                               ║                                 ║                                  
                               ║                                 ║                                  
                               ║                                 ║                                  
                               ║                                 ║                                  
                               ║                                 ║                                  
                               ║                                 ║                                  
                               ║                                 ║                                 