                                                                                                    
                               ║                                 ║                                  
                               ║                                 ║                                  
                               ║                                 ║                                  
                               ║                                 ║                                  
                               ║                                 ║                                  
                               ║                                 ║                                  
                               ║                                 ║                                  
                               ║                                 ║                                  
                               ║                                 ║                                  
                               ║                                 ║                                  
                               ║                                 ║                                  
═══════════════════════════════╝                                 ║                                  
                                                                 ║                                  
                                                                 ║                                  
                                                                 ║                                  
                                                                 ║                                  
                                                                 ║                                  
                                                                 ║                                  
                                                                 ║                                  
                                                                 ║                                  
                                                                 ║                                  
                                                                 ║                                  
═══════════════════════════════╦═════════════════════════════════╬══════════════════════════════════
                               ║                                 ║                                  
                               ║                                 ║                                  
                               ║                                 ║                                  
                               ║                                 ║                                  
                               ║                                 ║                                  
                               ║                                 ║                                  
                               ║                                 ║                                  
                               ║                                 ║                                  
                               ║                                 ║                                  
                               ║                                 ║                                 